Version	Version
Recipient_Number	Recipient_Number
Account_Number	Account_Number
Account_Country	Account_Country
Invoice_Date	Invoice_Date
Invoice_Number	Invoice_Number
Invoice_Type_Code	Invoice_Type_Code
Invoice_Type_Detail_Code	Invoice_Type_Detail_Code
Account_Tax_ID	Account_Tax_ID
Invoice_Currency_Code	Invoice_Currency_Code
Invoice_Amount	Invoice_Amount
Transaction_Date	Transaction_Date
Pickup_Record_Number	Pickup_Record_Number
Lead_Shipment_Number	Lead_Shipment_Number
World_Ease_Number	World_Ease_Number
Shipment_Reference_Number_1	Shipment_Reference_Number_1
Shipment_Reference_Number_2	Shipment_Reference_Number_2
Bill_Option_Code	Bill_Option_Code
Package_Quantity	Package_Quantity
Oversize_Quantity	Oversize_Quantity
Tracking_Number	Tracking_Number
Package_Reference_Number_1	Package_Reference_Number_1
Package_Reference_Number_2	Package_Reference_Number_2
Package_Reference_Number_3	Package_Reference_Number_3
Package_Reference_Number_4	Package_Reference_Number_4
Package_Reference_Number_5	Package_Reference_Number_5
Entered_Weight	Entered_Weight
Entered_Weight_Unit_of_Measure	Entered_Weight_Unit_of_Measure
Billed_Weight	Billed_Weight
Billed_Weight_Unit_of_Measure	Billed_Weight_Unit_of_Measure
Container_Type	Container_Type
Billed_Weight_Type	Billed_Weight_Type
Package_Dimensions	Package_Dimensions
Zone	Zone
Charge_Category_Code	Charge_Category_Code
Charge_Category_Detail_Code	Charge_Category_Detail_Code
Charge_Source	Charge_Source
Type_Code_1	Type_Code_1
Type_Detail_Code_1	Type_Detail_Code_1
Type_Detail_Value_1	Type_Detail_Value_1
Type_Code_2	Type_Code_2
Type_Detail_Code_2	Type_Detail_Code_2
Type_Detail_Value_2	Type_Detail_Value_2
Charge_Classification_Code	Charge_Classification_Code
Charge_Description_Code	Charge_Description_Code
Charge_Description	Charge_Description
Charged_Unit_Quantity	Charged_Unit_Quantity
Basis_Currency_Code	Basis_Currency_Code
Basis_Value	Basis_Value
Tax_Indicator	Tax_Indicator
Transaction_Currency_Code	Transaction_Currency_Code
Incentive_Amount	Incentive_Amount
Net_Amount	Net_Amount
Miscellaneous_Currency_Code	Miscellaneous_Currency_Code
Miscellaneous_Incentive_Amount	Miscellaneous_Incentive_Amount
Miscellaneous_Net_Amount	Miscellaneous_Net_Amount
Alternate_Invoicing_Currency_Code	Alternate_Invoicing_Currency_Code
Alternate_Invoice_Amount	Alternate_Invoice_Amount
Invoice_Exchange_Rate	Invoice_Exchange_Rate
Tax_Variance_Amount	Tax_Variance_Amount
Currency_Variance_Amount	Currency_Variance_Amount
Invoice_Level_Charge	Invoice_Level_Charge
Invoice_Due_Date	Invoice_Due_Date
Alternate_Invoice_Number	Alternate_Invoice_Number
Store_Number	Store_Number
Customer_Reference_Number	Customer_Reference_Number
Sender_Name	Sender_Name
Sender_Company_Name	Sender_Company_Name
Sender_Address_Line_1	Sender_Address_Line_1
Sender_Address_Line_2	Sender_Address_Line_2
Sender_City	Sender_City
Sender_State	Sender_State
Sender_Postal	Sender_Postal
Sender_Country	Sender_Country
Receiver_Name	Receiver_Name
Receiver_Company_Name	Receiver_Company_Name
Receiver_Address_Line_1	Receiver_Address_Line_1
Receiver_Address_Line_2	Receiver_Address_Line_2
Receiver_City	Receiver_City
Receiver_State	Receiver_State
Receiver_Postal	Receiver_Postal
Receiver_Country	Receiver_Country
Third_Party_Name	Third_Party_Name
Third_Party_Company_Name	Third_Party_Company_Name
Third_Party_Address_Line_1	Third_Party_Address_Line_1
Third_Party_Address_Line_2	Third_Party_Address_Line_2
Third_Party_City	Third_Party_City
Third_Party_State	Third_Party_State
Third_Party_Postal	Third_Party_Postal
Third_Party_Country	Third_Party_Country
Sold_To_Name	Sold_To_Name
Sold_To_Company_Name	Sold_To_Company_Name
Sold_To_Address_Line_1	Sold_To_Address_Line_1
Sold_To_Address_Line_2	Sold_To_Address_Line_2
Sold_To_City	Sold_To_City
Sold_To_State	Sold_To_State
Sold_To_Postal	Sold_To_Postal
Sold_To_Country	Sold_To_Country
Miscellaneous_Address_Qual_1	Miscellaneous_Address_Qual_1
Miscellaneous_Address_1_Name	Miscellaneous_Address_1_Name
Miscellaneous_Address_1_Company_Name	Miscellaneous_Address_1_Company_Name
Miscellaneous_Address_1_Address_Line_1	Miscellaneous_Address_1_Address_Line_1
Miscellaneous_Address_1_Address_Line_2	Miscellaneous_Address_1_Address_Line_2
Miscellaneous_Address_1_City	Miscellaneous_Address_1_City
Miscellaneous_Address_1_State	Miscellaneous_Address_1_State
Miscellaneous_Address_1_Postal	Miscellaneous_Address_1_Postal
Miscellaneous_Address_1_Country	Miscellaneous_Address_1_Country
Miscellaneous_Address_Qual_2	Miscellaneous_Address_Qual_2
Miscellaneous_Address_2_Name	Miscellaneous_Address_2_Name
Miscellaneous_Address_2_Company_Name	Miscellaneous_Address_2_Company_Name
Miscellaneous_Address_2_Address_Line_1	Miscellaneous_Address_2_Address_Line_1
Miscellaneous_Address_2_Address_Line_2	Miscellaneous_Address_2_Address_Line_2
Miscellaneous_Address_2_City	Miscellaneous_Address_2_City
Miscellaneous_Address_2_State	Miscellaneous_Address_2_State
Miscellaneous_Address_2_Postal	Miscellaneous_Address_2_Postal
Miscellaneous_Address_2_Country	Miscellaneous_Address_2_Country
Shipment_Date	Shipment_Date
Shipment_Export_Date	Shipment_Export_Date
Shipment_Import_Date	Shipment_Import_Date
Entry_Date	Entry_Date
Direct_Shipment_Date	Direct_Shipment_Date
Shipment_Delivery_Date	Shipment_Delivery_Date
Shipment_Release_Date	Shipment_Release_Date
Cycle_Date	Cycle_Date
EFT_Date	EFT_Date
Validation_Date	Validation_Date
Entry_Port	Entry_Port
Entry_Number	Entry_Number
Export_Place	Export_Place
Shipment_Value_Amount	Shipment_Value_Amount
Shipment_Description	Shipment_Description
Entered_Currency_Code	Entered_Currency_Code
Customs_Number	Customs_Number
Exchange_Rate	Exchange_Rate
Master_Air_Waybill_Number	Master_Air_Waybill_Number
EPU	EPU
Entry_Type	Entry_Type
CPC_Code	CPC_Code
Line_Item_Number	Line_Item_Number
Goods_Description	Goods_Description
Entered_Value	Entered_Value
Duty_Amount	Duty_Amount
Weight	Weight
Unit_of_Measure	Unit_of_Measure
Item_Quantity	Item_Quantity
Item_Quantity_Unit_of_Measure	Item_Quantity_Unit_of_Measure
Import_Tax_ID	Import_Tax_ID
Declaration_Number	Declaration_Number
Carrier_Name	Carrier_Name
CCCD_Number	CCCD_Number
Cycle_Number	Cycle_Number
Foreign_Trade_Reference_Number	Foreign_Trade_Reference_Number
Job_Number	Job_Number
Transport_Mode	Transport_Mode
Tax_Type	Tax_Type
Tariff_Code	Tariff_Code
Tariff_Rate	Tariff_Rate
Tariff_Treatment_Number	Tariff_Treatment_Number
Contact_Name	Contact_Name
Class_Number	Class_Number
Document_Type	Document_Type
Office_Number	Office_Number
Document_Number	Document_Number
Duty_Value	Duty_Value
Total_Value_for_Duty	Total_Value_for_Duty
Excise_Tax_Amount	Excise_Tax_Amount
Excise_Tax_Rate	Excise_Tax_Rate
GST_Amount	GST_Amount
GST_Rate	GST_Rate
Order_In_Council	Order_In_Council
Origin_Country	Origin_Country
SIMA_Access	SIMA_Access
Tax_Value	Tax_Value
Total_Customs_Amount	Total_Customs_Amount
Miscellaneous_Line_1	Miscellaneous_Line_1
Miscellaneous_Line_2	Miscellaneous_Line_2
Miscellaneous_Line_3	Miscellaneous_Line_3
Miscellaneous_Line_4	Miscellaneous_Line_4
Miscellaneous_Line_5	Miscellaneous_Line_5
Payor_Role_Code	Payor_Role_Code
Miscellaneous_Line_7	Miscellaneous_Line_7
Miscellaneous_Line_8	Miscellaneous_Line_8
Miscellaneous_Line_9	Miscellaneous_Line_9
Miscellaneous_Line_10	Miscellaneous_Line_10
UPS_Internal_Use	UPS_Internal_Use
Field186	Field186
Field187	Field187
Field188	Field188
Field189	Field189
Field190	Field190
Field191	Field191
Field192	Field192
Field193	Field193
Field194	Field194
Field195	Field195
Field196	Field196
Field197	Field197
Field198	Field198
Field199	Field199
Field200	Field200
Field201	Field201
Field202	Field202
Field203	Field203
Field204	Field204
Field205	Field205
Field206	Field206
Field207	Field207
Field208	Field208
Field209	Field209
Field210	Field210
Field211	Field211
Field212	Field212
Field213	Field213
Field214	Field214
Field215	Field215
Field216	Field216
Field217	Field217
Field218	Field218
Field219	Field219
Field220	Field220
Field221	Field221
Field222	Field222
Field223	Field223
Field224	Field224
Field225	Field225
Field226	Field226
Field227	Field227
